

R   1920  1080

NO    ./textures/textureA/celestial64.xpm




SO ./textures/textureA/flower64.xpm

WE         ./textures/textureA/greendragon64.xpm
EA ./textures/textureA/treeolife64.xpm

S    ./sprites/ghost.xpm
F     220   ,    100,     0
C  225,    30,0

        11111111111111111111111000
       1111000000011000000000011111
        1011000001110000002000001
        1001000000000000000000001
111111111011000001110000000000001
100000000011000001110111111111111
11110111111111011100000010001
toto
tata
 1110111111111011101010010001
11000000110101011100000010001
100020000000000011000000100010000000000
10000000000000001101010010001
11000001110101011111011110N0111
11110111 1110101 101111010001
  111111 1111111 111111111111
wrong line a
wrong line b
wrong line c
wrong line e
