

 	R   	200480  360000
NO    ../textures/celestial64.xpm


	WE   	../textures/greendragon64.xpm
	EA ../textures/treeolife64.xpm


SO ../textures/flower64.xpm


S     ../sprites/ghost.xpm
	F      10   ,    120,     50
    	C  	50,    		50, 200

        11111111111111111111111000
       1111000000011000000000011111
     111101100000000000000000111
     1001000000000002000000011
    111111111111000001000000010000001
1111100000000000001110001101111111
11110111111111101100000010001
11101111111110011010000010201
11000000110101011100000010001
100000000200000000000000100010000000000
10000000000000000101010010001
11000001110101011111011110N0111
11110111 1110101 101111010001
  111111 1111111 111111111111



